22,22,22,22,22,22,22,22,22,22,22,22,22,22,22,22,22,22,22,22,22,22,22,22,22,22
22,18,14,14,14,14,14,14,14,14,19,22,22,22,22,22,22,22,22,22,22,22,22,22,22,22
22,12,25,02,02,02,02,02,02,02,15,19,22,22,22,22,22,22,22,22,22,22,22,22,22,22
22,12,01,16,10,10,10,10,11,25,29,23,22,22,22,22,22,22,18,14,14,14,14,19,22,22
22,12,25,23,22,22,22,22,12,04,01,23,22,22,22,22,22,22,12,30,30,29,25,23,22,22
22,12,27,15,14,14,14,14,13,04,24,23,22,22,22,22,22,22,12,24,29,25,29,23,22,22
22,12,30,04,28,28,29,25,04,29,01,23,22,22,22,22,22,22,12,29,29,28,28,23,22,22
22,17,11,01,24,01,16,10,10,10,10,20,22,22,22,22,22,22,17,10,10,10,10,20,22,22
22,22,17,11,01,27,15,14,14,19,22,22,22,22,22,22,18,14,14,14,14,14,19,22,22,22
22,22,22,17,10,11,01,02,01,15,14,14,14,19,22,22,12,26,25,29,26,25,23,22,22,22
22,22,22,18,14,13,07,24,01,09,28,06,01,23,22,22,12,29,29,26,26,26,23,22,22,22
22,22,22,12,26,26,29,28,06,16,10,10,10,20,22,22,17,11,29,26,26,16,20,22,22,22
18,14,14,13,26,16,10,10,10,20,22,18,14,14,14,14,14,13,26,24,30,15,14,14,19,22
12,01,01,01,26,23,22,22,22,22,22,12,01,25,01,01,01,28,27,01,27,01,01,24,23,22
12,01,01,01,26,15,14,14,14,14,14,13,01,01,28,27,16,10,10,10,11,26,30,01,23,22
17,10,10,11,26,27,27,27,27,27,27,27,27,26,27,01,23,18,14,19,12,01,28,24,23,22
22,22,22,12,26,01,01,01,01,01,01,01,25,28,29,27,23,12,24,23,12,01,29,01,23,22
22,22,18,13,26,16,10,11,24,16,10,11,28,30,29,25,23,17,10,20,12,26,26,01,23,22
22,22,12,04,01,15,19,12,25,23,22,12,25,25,26,01,15,14,14,14,13,28,25,01,23,22
22,22,12,25,01,01,23,17,10,20,22,12,01,01,25,01,01,24,01,01,24,28,01,24,23,22
22,22,17,10,10,10,20,22,22,22,22,17,10,10,10,10,10,10,10,10,10,10,10,10,20,22
22,22,22,22,22,22,22,22,22,22,22,22,22,22,22,22,22,22,22,22,22,22,22,22,22,22